10
  ########
# # #    #
# # #### #
# #      #
# # # ####
# # #    #
#   # #  #
##### ####
#        #
######## 